WWWWWWWWWWWWWWWWWWWWWWWWWWWWWW
W       W    W     T         W
W       W          T         W
W     WWW     TTTTTWWWWW     W
W     W             W        W
W     WWWW          W        W
W         W                  W
W                            W
W                      TTTTTTW
WWWWWWWWWWWWWWWWWWWWWWWWWWWWWW